R 1000 800
NO ./maps/texture/bluestone.xpm
SO ./maps/texture/bluestone.xpm
EA ./maps/texture/bluestone.xpm
WE ./maps/texture/bluestone.xpm

S ./maps/texture/barrel.xpm
F 220,100,0
C 225,30,0

        1111111111111111111111111
        1000000000110000000000001
        1011000001110000000000001
        1001000000000000020000001
111111111011000001110000000000001
100000000011000001110111111111111
11110111111111011100000010001
11110111111111011101010000201
11000000110101011100010010201
100000000000000011001 1010001
10000000000000001100010010001
11000001110101011111000010N0111
11110111 1110101 100000010001
11111111 1111111 111111111111
